|L|L|L|L|L|L|L|L|L|L|L|L|L|L|L|L|L|L|L|L|L|L|L|L|L|L|L|L|L|L|L|L|L|L|L|L|L|L|L|L|L|L|L|L|L|L|L|L|L|L|L|L|L|L|L|L|L|L|L|L|L|L|L|L|L|L|L|L|L|L|L|L|L|L|L|L|L|L|L|L|L|L|L|L|L|L|L|L|L|L|L|L|L|L|L|L|L|L|L|L|L|L|L|L|L|L|L|L|L|L|L|L|L|L|L|L|L|L|L|L|L|L|L|L|L|L|L|L|L|L
|L|L|L|L|L|L|L|L|L|L|L|L|L|L|L|L|L|L|L|L|L|L|L|L|L|L|L|L|L|L|L|L|L|L|L|L|L|L|L|L|L|L|L|L|L|L|L|L|L|L|L|L|L|L|L|L|L|L|L|L|L|L|L|L|L|L|L|L|L|L|L|L|L|L|L|L|L|L|L|L|L|L|L|L|L|L|L|L|L|L|L|L|L|L|L|L|L|L|L|L|L|L|L|L|L|L|L|L|L|L|L|L|L|L|L|L|L|L|L|L|L|L|L|L|L|L|L|L|L|L
|L|L|L|L|L|L|L|L|L|L|L|s|L|L|L|L|L|L|L|L|L|L|L|L|L|L|L|L|L|L|L|L|L|L|L|L|L|L|L|L|L|L|L|L|L|L|L|L|L|L|L|L|L|L|L|L|L|L|L|L|L|L|L|L|L|L|L|L|L|L|L|L|L|L|L|L|L|L|L|L|L|L|L|L|L|L|L|L|L|L|L|L|L|L|L|L|L|L|L|L|L|L|L|L|L|L|L|L|L|L|L|L|L|L|L|L|L|L|L|L|L|L|L|L|L|L|L|L|L|L
|L|L|L|L|L|L|L|L|L|L|L|L|L|L|L|L|L|L|L|L|L|L|L|L|L|L|L|L|L|L|L|L|L|L|L|L|L|L|L|L|L|L|L|L|L|L|L|L|L|L|L|L|L|L|L|L|L|L|L|L|L|L|L|L|L|L|L|L|L|L|L|L|L|L|L|L|L|L|L|L|L|L|L|L|L|L|L|L|L|L|L|L|L|L|L|L|L|L|L|L|L|L|L|L|L|L|L|L|L|L|L|L|L|L|L|L|L|L|L|L|L|L|L|L|L|L|L|L|L|L
|L|L|L|L|L|L|L|L|L|L|L|L|L|L|L|L|L|L|L|L|L|L|L|L|L|L|L|L|L|L|L|L|L|L|L|L|L|L|L|L|L|L|L|L|L|L|L|L|L|L|L|L|L|L|L|L|L|L|L|L|L|L|L|L|L|L|L|L|L|L|L|L|L|L|L|L|L|L|L|L|L|L|L|L|L|L|L|L|L|L|L|L|L|L|L|L|L|L|L|L|L|L|L|L|L|L|L|L|L|L|L|L|L|L|L|L|L|L|L|L|L|L|L|L|L|L|L|L|L|L
|L|L|L|L|L|L|L|L|L|L|L|L|L|L|L|L|L|L|L|L|L|L|L|L|L|L|L|L|L|L|L|L|L|L|L|L|L|L|L|L|L|L|L|L|L|L|L|L|L|L|L|L|L|L|L|L|L|L|L|L|L|L|L|L|L|L|L|L|L|L|L|L|L|L|L|L|L|L|L|L|L|L|L|L|L|L|L|L|L|L|L|L|L|L|L|L|L|L|L|L|L|L|L|L|L|L|L|L|L|L|L|L|L|L|L|L|L|L|L|L|L|L|L|L|L|L|L|L|L|L
|L|L|L|L|L|L|L|L|L|L|L|L|L|L|L|L|L|L|L|L|L|L|L|L|L|L|L|L|L|L|L|L|L|L|L|L|L|L|L|L|L|L|L|L|L|L|L|L|L|L|L|L|L|L|L|L|L|L|L|L|L|L|L|L|L|L|L|L|L|L|L|L|L|L|L|L|L|L|L|L|L|L|L|L|L|L|L|L|L|L|L|L|L|L|L|L|L|L|L|L|L|L|L|L|L|L|L|L|L|L|L|L|L|L|L|L|L|L|L|L|L|L|L|L|L|L|L|L|L|L
|L|L|L|L|L|L|L|L|L|L|L|L|L|L|L|L|L|L|L|L|L|L|L|L|L|L|L|L|L|L|L|L|L|L|L|L|L|L|L|L|L|L|L|L|L|L|L|L|L|L|L|L|L|L|L|L|L|L|L|L|L|L|L|L|L|L|L|L|L|L|L|L|L|L|L|L|L|L|L|L|L|L|L|L|L|L|L|L|L|L|L|L|L|L|L|L|L|L|L|L|L|L|L|L|L|L|L|L|L|L|L|L|L|L|L|L|L|L|L|L|L|L|L|L|L|L|L|L|L|L
|L|L|L|L|L|L|L|L|L|L|L|L|L|L|L|L|L|L|L|L|L|L|L|L|L|L|L|L|L|L|L|L|L|L|L|L|L|L|L|L|L|L|L|L|L|L|L|L|L|L|L|L|L|L|L|L|L|L|L|L|L|L|L|L|L|L|L|L|L|L|L|L|L|L|L|L|L|L|L|L|L|L|L|L|L|L|L|L|L|L|L|L|L|L|L|L|L|L|L|L|L|L|L|L|L|L|L|L|L|L|L|L|L|L|L|L|L|L|L|L|L|L|L|L|L|L|L|L|L|L
|L|L|L|L|L|L|L|L|L|L|L|L|L|L|L|L|L|L|L|L|L|L|L|L|L|L|L|L|L|L|L|L|L|L|L|L|L|L|L|L|L|L|L|L|L|L|L|L|L|L|L|L|L|L|L|L|L|L|L|L|L|L|L|L|L|L|L|L|L|L|L|L|L|L|L|L|L|L|L|L|L|L|L|L|L|L|L|L|L|L|L|L|L|L|L|L|L|L|L|L|L|L|L|L|L|L|L|L|L|L|L|L|L|L|L|L|L|L|L|L|L|L|L|L|L|L|L|L|L|L
|L|L|L|L|L|L|L|L|L|L|L|L|L|L|L|L|L|L|L|L|L|L|L|L|L|L|L|L|L|L|L|L|L|L|L|L|L|L|L|L|L|L|L|L|L|L|L|L|L|L|L|L|L|L|L|L|L|L|L|L|L|L|L|L|L|L|L|L|L|L|L|L|L|L|L|L|L|L|L|L|L|L|L|L|L|L|L|L|L|L|L|L|L|L|L|L|L|L|L|L|L|L|L|L|L|L|L|L|L|L|L|L|L|L|L|L|L|L|L|L|L|L|L|L|L|L|L|L|L|L
|L|L|L|L|L|L|L|L|L|L|L|L|L|L|L|L|L|L|L|L|L|L|L|L|L|L|L|L|L|L|L|L|L|L|L|L|L|L|L|L|L|L|L|L|L|L|L|L|L|L|L|L|L|L|L|L|L|L|L|L|L|L|L|L|L|L|L|L|L|L|L|L|L|L|L|L|L|L|L|L|L|L|L|L|L|L|L|L|L|L|L|L|L|L|L|L|L|L|L|L|L|L|L|L|L|L|L|L|L|L|L|L|L|L|L|L|L|L|L|L|L|L|L|L|L|L|L|L|L|L
|L|L|L|L|L|L|L|L|L|L|L|L|L|L|L|L|L|L|L|L|L|L|L|L|L|L|L|L|L|L|L|L|L|L|L|L|L|L|L|L|L|L|L|L|L|L|L|L|L|L|L|L|L|L|L|L|L|L|L|L|L|L|L|L|L|L|L|L|L|L|L|L|L|L|L|L|L|L|L|L|L|L|L|L|L|L|L|L|L|L|L|L|L|L|L|L|L|L|L|L|L|L|L|L|L|L|L|L|L|L|L|L|L|L|L|L|L|L|L|L|L|L|L|L|L|L|L|L|L|L
|L|L|L|L|L|L|L|L|L|L|L|L|L|L|L|L|L|L|L|L|L|L|L|L|L|L|L|L|L|L|L|L|L|L|L|L|L|L|L|L|L|L|L|L|L|L|L|L|L|L|L|L|L|L|L|L|L|L|L|L|L|L|L|L|L|L|L|L|L|L|L|L|L|L|L|L|L|L|L|L|L|L|L|L|L|L|L|L|L|L|L|L|L|L|L|L|L|L|L|L|L|L|L|L|L|L|L|L|L|L|L|L|L|L|L|L|L|L|L|L|L|L|L|L|L|L|L|L|L|L
|L|L|L|L|L|L|L|L|L|L|L|L|L|L|L|L|L|L|L|L|L|L|L|L|L|L|L|L|L|L|L|L|L|L|L|L|L|L|L|L|L|L|L|L|L|L|L|L|L|L|L|L|L|L|L|L|L|L|L|L|L|L|L|L|L|L|L|L|L|L|L|L|L|L|L|L|L|L|L|L|L|L|L|L|L|L|L|L|L|L|L|L|L|L|L|L|L|L|L|L|L|L|L|L|L|L|L|L|L|L|L|L|L|L|L|L|L|L|L|L|L|L|L|L|L|L|L|L|L|L
|L|L|L|L|L|L|L|L|L|L|L|L|L|L|L|L|L|L|L|L|L|L|L|L|L|L|L|L|L|L|L|L|L|L|L|L|L|L|L|L|L|L|L|L|L|L|L|L|L|L|L|L|L|L|L|L|L|L|L|L|L|L|L|L|L|L|L|L|L|L|L|L|L|L|L|L|L|L|L|L|L|L|L|L|L|L|L|L|L|L|L|L|L|L|L|L|L|L|L|L|L|L|L|L|L|L|L|L|L|L|L|L|L|L|L|L|L|L|L|L|L|L|L|L|L|L|L|L|L|L
|L|L|L|L|L|L|L|L|L|L|L|L|L|L|L|L|L|L|L|L|L|L|L|L|L|L|L|L|L|L|L|L|L|L|L|L|L|L|L|L|L|L|L|L|L|L|L|L|L|L|L|L|L|L|L|L|L|L|L|L|L|L|L|L|L|L|L|L|L|L|L|L|L|L|L|L|L|L|L|L|L|L|L|L|L|L|L|L|L|L|L|L|L|L|L|L|L|L|L|L|L|L|L|L|L|L|L|L|L|L|L|L|L|L|L|L|L|L|L|L|L|L|L|L|L|L|L|L|L|L
|L|L|L|L|L|L|L|L|L|L|L|L|L|L|L|L|L|L|L|L|L|L|L|L|L|L|L|L|L|L|L|L|L|L|L|L|L|L|L|L|L|L|L|L|L|L|L|L|L|L|L|L|L|L|L|L|L|L|L|L|L|L|L|L|L|L|L|L|L|L|L|L|L|L|L|L|L|L|L|L|L|L|L|L|L|L|L|L|L|L|L|L|L|L|L|L|L|L|L|L|L|L|L|L|L|L|L|L|L|L|L|L|L|L|L|L|L|L|L|L|L|L|L|L|L|L|L|L|L|L
|L|L|L|L|L|L|L|L|L|L|L|L|L|L|L|L|L|L|L|L|L|L|L|L|L|L|L|L|L|L|L|L|L|L|L|L|L|L|L|L|L|L|L|L|L|L|L|L|L|L|L|L|L|L|L|L|L|L|L|L|L|L|L|L|L|L|L|L|L|L|L|L|L|L|L|L|L|L|L|L|L|L|L|L|L|L|L|L|L|L|L|L|L|L|L|L|L|L|L|L|L|L|L|L|L|L|L|L|L|L|L|L|L|L|L|L|L|L|L|L|L|L|L|L|L|L|L|L|L|L
|L|L|L|L|L|L|L|L|L|L|L|L|L|L|L|L|L|L|L|L|L|L|L|L|L|L|L|L|L|L|L|L|L|L|L|L|L|L|L|L|L|L|L|L|L|L|L|L|L|L|L|L|L|L|L|L|L|L|L|L|L|L|L|L|L|L|L|L|L|L|L|L|L|L|L|L|L|L|L|L|L|L|L|L|L|L|L|L|L|L|L|L|L|L|L|L|L|L|L|L|L|L|L|L|L|L|L|L|L|L|L|L|L|L|L|L|L|L|L|L|L|L|L|L|L|L|L|L|L|L
|L|L|L|L|L|L|L|L|L|L|L|L|L|L|L|L|L|L|L|L|L|L|L|L|L|L|L|L|L|L|L|L|L|L|L|L|L|L|L|L|L|L|L|L|L|L|L|L|L|L|L|L|L|L|L|L|L|L|L|L|L|L|L|L|L|L|L|L|L|L|L|L|L|L|L|L|L|L|L|L|L|L|L|L|L|L|L|L|L|L|L|L|L|L|L|L|L|L|L|L|L|L|L|L|L|L|L|L|L|L|L|L|L|L|L|L|L|L|L|L|L|L|L|L|L|L|L|L|L|L
|L|L|L|L|L|L|L|L|L|L|L|L|L|L|L|L|L|L|L|L|L|L|L|L|L|L|L|L|L|L|L|L|L|L|L|L|L|L|L|L|L|L|L|L|L|L|L|L|L|L|L|L|L|L|L|L|L|L|L|L|L|L|L|L|L|L|L|L|L|L|L|L|L|L|L|L|L|L|L|L|L|L|L|L|L|L|L|L|L|L|L|L|L|L|L|L|L|L|L|L|L|L|L|L|L|L|L|L|L|L|L|L|L|L|L|L|L|L|L|L|L|L|L|L|L|L|L|L|L|L
|L|L|L|L|L|L|L|L|L|L|L|L|L|L|L|L|L|L|L|L|L|L|L|L|L|L|L|L|L|L|L|L|L|L|L|L|L|L|L|L|L|L|L|L|L|L|L|L|L|L|L|L|L|L|L|L|L|L|L|L|L|L|L|L|L|L|L|L|L|L|L|L|L|L|L|L|L|L|L|L|L|L|L|L|L|L|L|L|L|L|L|L|L|L|L|L|L|L|L|L|L|L|L|L|L|L|L|L|L|L|L|L|L|L|L|L|L|L|L|L|L|L|L|L|L|L|L|L|L|L
|L|L|L|L|L|L|L|L|L|L|L|L|L|L|L|L|L|L|L|L|L|L|L|L|L|L|L|L|L|L|L|L|L|L|L|L|L|L|L|L|L|L|L|L|L|L|L|L|L|L|L|L|L|L|L|L|L|L|L|L|L|L|L|L|L|L|L|L|L|L|L|L|L|L|L|L|L|L|L|L|L|L|L|L|L|L|L|L|L|L|L|L|L|L|L|L|L|L|L|L|L|L|L|L|L|L|L|L|L|L|L|L|L|L|L|L|L|L|L|L|L|L|L|L|L|L|L|L|L|L
|L|L|L|L|L|L|L|L|L|L|L|L|L|L|L|L|L|L|L|L|L|L|L|L|L|L|L|L|L|L|L|L|L|L|L|L|L|L|L|L|L|L|L|L|L|L|L|L|L|L|L|L|L|L|L|L|L|L|L|L|L|L|L|L|L|L|L|L|L|L|L|L|L|L|L|L|L|L|L|L|L|L|L|L|L|L|L|L|L|L|L|L|L|L|L|L|L|L|L|L|L|L|L|L|L|L|L|L|L|L|L|L|L|L|L|L|L|L|L|L|L|L|L|L|L|L|L|L|L|L
|L|L|L|L|L|L|L|L|L|L|L|L|L|L|L|L|L|L|L|L|L|L|L|L|L|L|L|L|L|L|L|L|L|L|L|L|L|L|L|L|L|L|L|L|L|L|L|L|L|L|L|L|L|L|L|L|L|L|L|g|L|L|L|L|L|L|L|L|L|L|L|L|L|L|L|L|L|L|L|L|L|L|L|L|L|L|L|L|L|L|L|L|L|L|L|L|L|L|L|L|L|L|L|L|L|L|L|L|L|L|L|L|L|L|L|L|L|L|L|L|L|L|L|L|L|L|L|L|L|L
|L|L|L|L|L|L|L|L|L|L|L|L|L|L|L|L|L|L|L|L|L|L|L|L|L|L|L|L|L|L|L|L|L|L|L|L|L|L|L|L|L|L|L|L|L|L|L|L|L|L|L|L|L|L|L|L|L|L|L|L|L|L|L|L|L|L|L|L|L|L|L|L|L|L|L|L|L|L|L|L|L|L|L|L|L|L|L|L|L|L|L|L|L|L|L|L|L|L|L|L|L|L|L|L|L|L|L|L|L|L|L|L|L|L|L|L|L|L|L|L|L|L|L|L|L|L|L|L|L|L
|L|L|L|L|L|L|L|L|L|L|L|L|L|L|L|L|L|L|L|L|L|L|L|L|L|L|L|L|L|L|L|L|L|L|L|L|L|L|L|L|L|L|L|L|L|L|L|L|L|L|L|L|L|L|L|L|L|L|L|L|L|L|L|L|L|L|L|L|L|L|L|L|L|L|L|L|L|L|L|L|L|L|L|L|L|L|L|L|L|L|L|L|L|L|L|L|L|L|L|L|L|L|L|L|L|L|L|L|L|L|L|L|L|L|L|L|L|L|L|L|L|L|L|L|L|L|L|L|L|L
|L|L|L|L|L|L|L|L|L|L|L|L|L|L|L|L|L|L|L|L|L|L|L|L|L|L|L|L|L|L|L|L|L|L|L|L|L|L|L|L|L|L|L|L|L|L|L|L|L|L|L|L|L|L|L|L|L|L|L|L|L|L|L|L|L|L|L|L|L|L|L|L|L|L|L|L|L|L|L|L|L|L|L|L|L|L|L|L|L|L|L|L|L|L|L|L|L|L|L|L|L|L|L|L|L|L|L|L|L|L|L|L|L|L|L|L|L|L|L|L|L|L|L|L|L|L|L|L|L|L
